R 100000000000000000000000000000000000000000000000 10000000000000000000000000000000000000000000000000


F 127,127,127
C 129,192,238

NO ./pics/tile7.xpm
SO ./pics/tile41.xpm
WE ./pics/tile42.xpm
EA ./pics/tile43.xpm
S ./pics/armor.xpm


11111111111111111111111111111111111111111111111111111111111111111111111111111111
10000000000000000000000000000000000000000000000000000000000000000000000000000001
10000000000000020000000000000111111111111111111110000000000000000200000000000001
10000000000000000000000011111111111111111111111111100000000000000000000000000001
10000000000000000000011111111111111111111111111111111100000000011000110110000001
10000101011000000001111111111111111111111111111111111111100000001101101111000001
101101010110000001111111111    1111111111111    11111111110000000111111110000001
10111111111000001111111111      11111111111      1111111111100001111111100000001
10001111111000011111111111      11111111111      1111111111111111111111100000001
100011111111111111111111111    1111111111111    11111111111111  1111111000000001
10000111111111111111111111111111111111111111111111111111111111     1111000000001
100000111   111111111111111111111111111111111111111111111111111     111110000001
100001111   111111111111111111111111111111111111111111111111111       1111000001
10000111    1111111111111111111111111111111111111111111111 111111111111111110001
10001111111111111  1111111111111111111111111111111111111   111111111111111111001
10001111111111111   1111111111111111111111111111111111     111111111111000000001
100111100000001111    111111111111111111111111111111      1111000000000000000001
10000000000000001111          111111111111111           111100000000000000000001
1000000000020000011111    N                           11111000000000000000000001
100000000000000000111111      11111111111111        1111100000000000000000000001
1000000000000000000011111111     1111111111111   1111111000000000000000000000001
1000000000000000000000011111111111  11111111111111111000000000000000000000000001
1000200000000000000000000011111111111 111111111100000000000000000000020000000001
10000000000000000000000000000000001111111111111110000000000000000000000000000001
10000000000000000000000000000000000000111111111111000000000000000000000000000001
10000000000000000000000000000000000000011111111111000000000000000000000000000001
10000000000000000000000000000000000000000111111110000000000000000000000000000001
10000000000000000000000000000000000000000000000000000000000000000000000000000001
11111111111111111111111111111111111111111111111111111111111111111111111111111111
