R 1200 800
NO ./pics/rock_wall.xpm
SO ./pics/rock_wall2.xpm
WE ./pics/rock_wall3.xpm
EA ./pics/rock_wall4.xpm

S ./pics/plant-green.xpm
F 76,70,50
C 126,192,238




1111111111111111111111111

1000000000110000000000001
1011000001110000002000001
1001000000000000000011111
111111111011000001110000000000001
100000000011000001110111111111111
11110111111111011100000010001
11110111111111011101010010001
11000000110101011100000010001
1001210000100S001100000010001
10000000002000001101010010001
1100000111110101111101111000111
11112111 1110121 121111010001
11111111 1111111 111121111111
