R 800 600

F 127,127,127
C 129,192,238

NO ./pics/tile7.xpm
SO ./pics/tile41.xpm
WE ./pics/tile42.xpm
EA ./pics/tile43.xpm

S ./pics/lamp.xpm
SS ./pics/table-chairs.xpm

              11111111       111111111111          
             110000001      11000000000011         
            1100020001     1100000000000011        
           11000000001    110200111111100011       
          110000000001    1111111     100001       
         1100001000001                102001       
        11000011000001                100001       
       1100001 1000001    111111111111100001       
      1100001  1003001    100000000000000001       
     110000011110000011111100000111111111111       
    11000000000000N00002000000001                  
    11000000300000000111111000001                  
    111111111111000001   1100000111111111111       
               1002001   1100200000000000001       
               1000001   1100000000000000001       
               1111111   1111111111111111111       
