R 800 600

F 127,127,127
C 129,192,238

NO ./pics/tile7.xpm
SS ./pics/table-chairs.xpm
SO ./pics/tile41.xpm
WE ./pics/tile42.xpm
EA ./pics/tile43.xpm

S ./pics/lamp.xpm

1111111111111111111111111
1000000000110000000000001
1011003001110000002000001
1001000000000030000011111
111111111011000001110000000000001
100000000011000001110111111111111
11110111111111011100000010001
11110111111111011101010010001
11000000110101011100000010001
1001210000100S001100000010001
10000000002000031101010010001
1100000111110101111101111000111
11112111 1110121 121111010001
11111111 1111111 111121111111
